Ideas:
mongolic group {kalmyk, mongol, buryat} - Kheshig (HC, HA, morale and defence buffs, usable even if nomadic)
samoyedic group + ket - Samyedic warriors (same as Kalaallit hunters)

czech - Taborites (pikes and archers, high defence)

Sharing suggestions:
manx - same as old_welsh - on hold
hui - same as han (expand retinue to chinese_group)
ket - same as samoyedic (probably shuld unmerge them from balts, it was a stupid idea)
zabbalin - same as coptic

No ideas for now:
Korean - korea_group
Romani - romani
Slunska - silesian
Hungarian - hungarian
iranian other than Afghan - group {baloch, hazar, tajik, persian, khorasani, alan}
caucasian - group {georgian, armenian, chechen}
niger_congolese - group {tashadian, hausa, nigerian, other nigerian cultures}
west_turkic other than Turk - group {avar, tatarian, azerbaijani, turkmen}
east_turkic - group {bashkir, kazakh, alagol, karakalpak, kirghiz, uyghur, yakut, evenki}
transistrian - group {moldavian, romanian, sazzac}

Scrapped ideas (not coming unless absolutely no idea for alternatives):
Hwachas for Koreans (too much effort for a one-culture unit)

Done:
Afghan - Jezzaliers
Spain/Portugal - Tercio/Terco
Greenland - Kalaallit hunters
Austria - Gebirgsjager
Germans, other than Austrians - Landsknechte
Amriqi - Al-Arambiz Riders
Konjara - Konjara Skirmishers

Central slavic - same as Eastern slavic
Samoyedic - same as Finno-ugric
Oglallan - same as Scottish

Buildings added:
Amriqi - Al-Arambiz Riders